1111111111111
1000100000001
1000000000001
1000000PCE001
1111111111111