1111111111111
1C10000000001
1010C00000001
100000PCE0001
1111111111111