1111111111111
1P000100000C1
1000000000001
10000001E0001
1111111111111