1111111111111
1000000000001
1000C00000001
100000PCE0001
1111111111111