1111111111111111111
1P1C000000001000001
10100001000100C0001
101C00000C010000001
101000000C000000001
10100C10010000C0001
1000010000000000001
101000C10000C000001
1E10100000000010001
1111111111111111111