1111111111
1000000001
1PC00000E1
1111111111