1111111
1P00001
1000001
1100001
1N00001
1100001
10000E1
1C00001
1000001
1100001
1000001
1111111