11111111111111
100P000N000001
11111100011111
100C0000000001
10111010111C01
10E000010000C1
11111111111111